@B	|贾]G@加kBkZ┮BQ猾恰BaU谴Z┮
GB	砰|恰B村a馈G@加kBk螃绔恰BG加Z┮
TB	瓜牙](@埭加のaU)の瓜绚G]GU加hkBkZ┮
|B	┑キмNj加(@埭Q加のaU)GU加hkBkZ┮
きB	u厩|GU加hkBkZ┮
せB	侯X@](@堀|加)GU加hkBkZ┮
CB	ㄆj加ヒBABT瓷GU加hkBkZ┮(ti崔t放)
KB	iボUBvU(@堀|加)GU加hkBkZ┮
EB	寒厩]GU加hkBkZ┮
QB	vt]GU加hkBkZ┮
Q@B	厩ネ“胜い摺GU加hkBkZ┮
QGB	寒g┮]GU加hkBkZ┮
QTB	宫歙t]のu{](公~ut)GU加hkBkZ┮
龟喷笆いみZ┮
Q|B	不伦の镭牡矫(lЫG加)GZ┮
QきB	侯XG]GU加hkBkZ┮
QせB	q诀t]GU加hkBkZ┮
QCB	t参u{厩tGU加hkBkZ┮
QKB	eut]GU加hkBkZ┮
QEB	u]GU加hkBkZ┮
GQB	戈utBq诀G]GU加hkBkZ┮
G@B	euG]GU加hkBkZ┮
GGB	扭j加(@埭C加)GU加hkBkZ┮
GTB	侯X悒sいみ(aU@hBaW|h)GU加hkBkZ┮
G|B	Hゅj加(aU@hBaWCh)GU加hkBkZ┮(tD)
GきB	韬蕤t](aWCh)GU加hkBkZ┮
GせB	簸U靖岛[y砰笆Oいみ(aUGhBaWTh)GU加hkBkZ┮
GCB	“胜い叻s丐j加(@埭C加のaU)GU加hkBkZ┮(tD)
GKB	吏挂て厩PネA悒s┮(aWGh)GU加hkBkZ┮
GEB	韫Bj加(tq衡いみ,诀瘪t,坝差tの近诀ut)GU加hkBkZ┮
TQB	{ネ毙厩悒sいみGU加hkBkZ┮
T@B	不伦刁虫ōJ(taU)GU加hD恰BZ┮
TGB	砰|]s丐j加(@埭T加)GU加hkBkZ┮(tD)
TTB	ネ炖]s丐j加(@埭患婴桅aU)GU加hkBkZ┮(tD)
T|B	韬2](K地)s丐j加(@埭加)GU加hkBkZ┮(tD)